  cell  ,E,W,N,S
"(1, 1)",1,0,0,0
"(2, 1)",1,0,0,1
"(3, 1)",1,0,1,0
"(4, 1)",1,0,0,1
"(5, 1)",1,0,1,0
"(1, 2)",1,1,0,1
"(2, 2)",0,1,1,0
"(3, 2)",1,1,0,1
"(4, 2)",1,1,1,0
"(5, 2)",1,1,0,0
"(1, 3)",0,1,0,1
"(2, 3)",1,0,1,0
"(3, 3)",1,1,0,0
"(4, 3)",1,1,0,1
"(5, 3)",1,1,1,0
"(1, 4)",1,0,0,1
"(2, 4)",0,1,1,1
"(3, 4)",1,1,1,1
"(4, 4)",1,1,1,0
"(5, 4)",1,1,0,0
"(1, 5)",1,1,0,1
"(2, 5)",1,0,1,1
"(3, 5)",0,1,1,0
"(4, 5)",1,1,0,1
"(5, 5)",1,1,1,0
"(1, 6)",1,1,0,0
"(2, 6)",0,1,0,1
"(3, 6)",1,0,1,0
"(4, 6)",1,1,0,0
"(5, 6)",1,1,0,0
"(1, 7)",1,1,0,1
"(2, 7)",1,0,1,1
"(3, 7)",1,1,1,1
"(4, 7)",0,1,1,1
"(5, 7)",1,1,1,0
"(1, 8)",1,1,0,0
"(2, 8)",1,1,0,0
"(3, 8)",1,1,0,1
"(4, 8)",0,0,1,1
"(5, 8)",1,1,1,0
"(1, 9)",1,1,0,1
"(2, 9)",0,1,1,1
"(3, 9)",1,1,1,1
"(4, 9)",1,0,1,0
"(5, 9)",1,1,0,0
"(1, 10)",0,1,0,1
"(2, 10)",0,0,1,1
"(3, 10)",0,1,1,0
"(4, 10)",0,1,0,1
"(5, 10)",0,1,1,0